***********************************************************************************
*                                                                                 *
*                                                                                 *
*                                                                                 *
*       #################################                                         *
*       #                               #                                         *
*       #                               #                                         *
*       #                               #                                         *
*       #                               #                                         *
*       #                               ##########################################*
*       #                                                                         *
*       #                                                                         *
*       #                                                                         *
*       #                                  ######################                 *
*       #                                  #                    #                 *
*       #                                  #                    #                 *
*       #                                  #                    #                 *
*       #####################              #                    #                 *
*                           #              #                    #                 *
*                           #              #                    #                 *
*                           #              #                    #                 *
*                           #              #                    #                 *
*                           #              #                    #                 *
*                           #              #                    #                 *
*                           #              #                    #                 *
* ##########################               #                    #                 *
*                                          #                    #          O      *
*                                          #                    #                 *
*                                          #                    #                 *
***********************************************************************************