************************************************************************************
*                                                                                  *
*                                                                                  *
*                                                                                  *
*       #################################                                          *
*       #                               #                                          *
*       #                               #                                          *
*       #                               #                                          *
*       #                               #                                          *
*       #                               ###########################################*
*       #                                                                          *
*       #                                                                          *
*       #                                                                          *
*       #                                  ######################                  *
*       #                                  #                    #                  *
*       #                                  #                    #                  *
*       #                                  #                    #                  *
*       #####################              #                    #                  *
*                           #              #                    #                  *
*                           #              #                    #                  *
*                           #              #                    #                  *
*                           #              #                    #                  *
*                           #              #                    #                  *
*                           #              #                    #                  *
*                           #              #                    #                  *
* ##########################               #                    #                  *
*                                          #                    #          O       *
*                                          #                    #                  *
*                                          #                    #                  *
************************************************************************************